{"Id":null,"Data":{"Id":"ad48084e-048d-4bbe-98cd-a0273697173e","CounterId":"fd70c480-a35a-494e-afbe-6010fffc827d","Timestamp":"2022-09-02T05:33:54.90294Z","PageSpecificMetrics":null,"Data":0.0},"Metadata":null}